111111111111
10EP00000001
100C00000001
100000010001
10C000101001
1000C0000001
1C00001C0001
111111111111