11111
10P01
1C001
10E01
10101
1A001
11111