11111
10P01
1C001
10E01
10101
10001
11111